Test Case - printLevelChoice function

Case 1
Input 		Expected Output 					Observed Output 
'VIEW'		Easy (15 stars) 					Easy (15 stars)
		*							* 
		**							** 
		***							*** 
		****							**** 
		***** 							*****

		Medium (55 stars)					Medium (55 stars) 
		*							* 
		**							** 
		***							*** 
		****							**** 
		*****							***** 
		******							****** 
		*******							******* 
		********						******** 
		*********						********* 
		**********						********** 

		Hard (120 stars)					Hard (120 stars) 
		*							* 
		**							** 
		***							***	 
		****							**** 
		*****							***** 
		******							****** 
		*******							******* 
		********						******** 
		*********						********* 
		**********						********** 
		***********						*********** 
		************						************ 
		*************						************* 
		**************						************** 
		***************						*************** 

Case 2
Input 		Expected Output 					Observed Output 
'E'		Easy (15 stars) 					Easy (15 stars)
		*							* 
		**							** 
		***							*** 
		****							**** 
		***** 							*****


Case 3
Input 		Expected Output 					Observed Output 
'M'		Medium (55 stars)					Medium (55 stars) 
		*							* 
		**							** 
		***							*** 
		****							**** 
		*****							***** 
		******							****** 
		*******							******* 
		********						******** 
		*********						********* 
		**********						********** 

Case 4
Input 		Expected Output 					Observed Output 
'H'		Hard (120 stars)					Hard (120 stars) 
		*							* 
		**							** 
		***							***	 
		****							**** 
		*****							***** 
		******							****** 
		*******							******* 
		********						******** 
		*********						********* 
		**********						********** 
		***********						*********** 
		************						************ 
		*************						************* 
		**************						************** 
		***************						*************** 

